ANTENNA	'Julius Rosenberg'
LIBERAL	'Julius Rosenberg'
KAPITAN	'President Roosevelt'
BABYLON	'San Francisco'
HOLA	'Melita Stedman Norwood'
GOT	'Percy Glading'
ANTON	'Leonid Romanovich Kvasnikov'
ENORMOZ	'Atomic Intelligence'
VOZDUKH	'Jet Propulsion'
RADUGA	'Radar'
SOHNCHEN	'Kim Philby'
ISLANDERS	'British Agent'
ISLAND	'Britain'
HOTEL	'British SIS'
ABO	'Peter Smollett'
FROST	'Boris Morros'
MAY	'Stepan Apresyan'
SERGEI	'Roland Abbiate aka Vladimir Pravdin'
TYRE OFFICE	'New York residency'
IGOR	'Konstantin Mikhailovich Kukin'
KRECHIN	'Boris Krotenschield alias Krotov'
